22 20 20 20 20 20 20 20 20 20 20 20 20 20 20 20 20 20 20 20 20 20 20 20 20 20 20 20 20 20 20 20 20 20 20 20 20 20 20 20 20 20 20 20 20 20 20 20 20 23
18 10 10 10 10 10 41 41 41 41 10 10 10 10 11 10 10 10 10 10 10 10 10 10 10 10 10 10 10 10 10 10 10 10 10 10 10 10 10 10 10 10 10 10 10 10 10 10 10 17
18 10 41 41 41 10 41 26 42 41 10 10 10 10 10 10 10 10 10 10 10 10 11 10 10 10 11 10 10 10 10 10 10 10 10 10 10 10 10 10 11 10 10 10 10 10 10 11 10 17
18 10 41 42 41 41 41 26 41 41 10 10 10 41 41 41 41 41 41 41 41 10 10 10 10 10 10 10 10 10 10 10 10 10 35 33 33 33 33 36 10 10 10 10 39 10 10 10 10 17
18 10 41 26 41 26 26 26 41 41 41 41 10 41 26 26 26 26 26 42 41 10 10 11 10 10 10 10 10 10 10 10 10 10 31 26 26 26 26 30 10 10 10 39 39 39 10 10 10 17
18 41 26 26 26 26 41 26 26 26 26 41 10 41 26 41 41 41 26 41 41 10 10 10 10 10 10 10 11 10 10 10 10 10 31 26 27 28 28 38 10 10 39 39 39 39 39 10 10 17
18 41 42 41 41 26 41 41 41 41 26 41 10 41 26 41 10 31 26 33 33 33 33 33 33 33 33 33 33 33 33 33 33 33 34 26 30 10 10 10 10 10 10 10 10 10 10 10 10 17
18 41 41 41 41 26 41 10 10 41 26 41 41 41 26 41 10 31 26 26 26 26 26 26 26 26 26 26 26 26 26 26 26 26 26 26 30 10 10 10 10 10 10 10 10 10 11 10 10 17
18 10 10 10 41 42 41 10 10 41 26 26 26 26 26 41 10 37 28 28 28 28 28 28 28 28 28 28 28 28 29 26 27 28 28 28 10 10 10 10 10 11 10 10 10 10 10 10 10 17
18 10 11 10 41 41 41 10 10 41 26 41 41 41 41 41 10 10 10 10 10 10 10 10 10 10 10 10 10 10 31 26 30 10 10 10 10 11 10 10 10 10 10 10 10 11 10 10 10 17
18 10 10 10 10 10 10 10 10 41 26 41 10 10 10 10 10 10 11 10 10 10 10 10 10 10 10 10 41 10 31 26 30 10 10 10 10 10 10 10 10 10 10 10 10 10 10 10 10 17
18 10 10 10 10 10 10 10 10 41 26 41 10 10 41 10 10 10 10 10 41 10 10 10 10 11 10 10 10 10 31 26 30 10 10 11 10 10 10 10 10 10 10 10 10 10 10 10 10 17
18 10 10 41 41 41 41 41 41 41 26 41 10 10 10 10 10 10 10 10 10 10 10 10 10 10 10 10 10 10 31 26 30 10 10 10 10 10 41 41 41 41 41 41 41 41 11 10 10 17
18 10 10 41 42 26 26 26 26 26 26 41 10 10 10 10 10 10 11 10 10 10 11 10 10 10 10 10 10 10 31 26 30 10 10 10 10 10 41 40 40 40 40 40 40 41 10 10 10 17
18 10 10 41 41 41 41 41 26 26 41 41 10 10 11 10 10 10 41 10 10 10 10 10 10 41 11 10 10 10 31 26 32 33 33 33 36 10 41 40 42 42 42 42 40 41 10 10 10 17
18 10 10 10 10 10 10 41 26 26 10 10 10 10 10 10 10 10 10 10 10 10 10 10 10 10 10 10 10 10 31 26 26 26 26 26 30 10 41 40 42 42 42 42 40 41 10 10 10 17
18 10 10 10 10 10 10 41 26 26 10 10 10 10 10 10 10 11 10 10 10 11 10 10 10 10 10 10 41 10 31 26 27 28 28 28 38 10 41 40 42 42 42 42 40 41 10 10 10 17
18 10 11 10 10 10 10 41 26 26 41 10 10 10 10 10 10 10 10 10 10 10 10 10 10 10 10 10 10 10 31 26 30 10 10 10 10 10 41 40 40 40 40 40 40 41 10 10 10 17
18 10 10 10 10 10 10 41 26 26 41 41 41 41 41 41 41 41 41 41 41 41 41 41 41 10 10 10 10 10 31 26 30 10 10 10 10 10 41 41 41 41 41 41 41 41 10 10 10 17
18 10 10 10 10 10 10 41 26 26 33 33 33 33 33 33 33 33 33 33 33 33 33 36 41 10 10 10 11 10 31 26 30 10 10 10 10 10 10 10 10 11 10 10 10 10 10 10 10 17
18 10 10 10 10 10 10 41 26 26 26 26 26 26 26 26 26 26 26 26 26 26 26 30 41 10 10 10 41 10 31 26 30 10 10 10 10 10 10 10 10 10 10 10 10 10 10 11 10 17
18 10 10 10 10 10 10 41 41 41 41 28 28 28 28 28 28 28 28 28 28 29 26 30 41 10 10 10 10 10 31 26 30 10 10 11 10 10 11 10 10 10 10 10 10 10 10 10 10 17
18 10 41 41 41 11 10 10 10 10 41 14 15 15 15 15 15 15 15 15 16 31 26 30 41 10 10 10 10 10 31 26 30 10 10 10 10 10 10 10 10 10 10 43 43 43 10 10 10 17
18 10 41 42 41 11 10 10 10 10 41 17 12 13 12 12 12 12 12 13 18 31 26 30 41 10 10 10 10 11 31 26 32 33 33 33 33 33 33 36 10 10 43 43 43 43 43 10 10 17
18 10 41 26 41 10 10 10 10 10 41 17 12 12 12 13 13 12 12 12 18 31 26 30 41 10 10 10 10 10 31 26 26 26 26 26 26 26 26 30 10 43 43 43 12 43 43 43 10 17
18 10 41 26 41 10 10 10 10 10 41 17 12 12 13 12 13 12 12 12 18 31 26 30 41 10 11 10 10 10 37 28 28 28 28 28 28 28 28 38 10 43 43 12 12 12 43 43 10 17
18 10 41 26 41 10 11 10 10 10 41 17 12 12 12 12 13 12 13 12 18 31 26 30 41 10 10 10 10 10 10 10 10 10 10 10 10 10 10 10 10 43 43 12 43 43 43 43 10 17
18 10 41 26 41 10 10 10 10 10 41 17 12 13 12 12 12 13 12 12 18 31 26 30 41 10 42 41 10 10 10 10 10 10 10 10 10 10 10 10 10 43 43 12 12 12 43 43 10 17
18 10 11 28 10 10 10 10 10 10 41 19 20 20 20 20 20 20 20 20 21 31 26 30 41 10 10 10 10 10 10 10 10 11 10 10 11 10 10 10 10 43 43 43 43 12 43 43 10 17
18 10 10 10 10 10 10 10 10 10 41 41 41 41 41 41 41 35 33 33 33 34 26 30 10 10 10 10 10 10 10 10 10 10 10 10 10 10 10 10 10 43 43 12 12 12 43 43 10 17
18 10 10 10 10 10 10 11 10 10 10 10 10 10 10 10 10 31 26 26 26 26 26 30 10 10 10 10 10 10 10 10 10 42 41 10 10 10 10 10 10 10 43 43 12 43 43 10 10 17
18 10 10 10 10 11 10 10 10 10 10 10 11 10 10 10 10 31 26 27 28 28 28 38 10 10 10 10 10 10 10 10 10 10 10 10 10 10 10 11 10 10 10 43 43 43 10 10 10 17
18 11 10 10 10 10 10 10 10 10 10 10 10 10 10 10 10 31 26 30 10 10 10 10 10 10 10 10 10 10 10 10 11 10 10 11 10 10 10 10 10 10 10 10 10 10 10 10 10 17
18 10 10 10 10 10 10 10 10 10 10 10 10 10 10 10 10 31 26 30 10 42 41 10 10 10 10 10 10 10 10 10 10 10 10 10 10 10 10 10 10 10 10 10 10 10 11 10 10 17
18 10 10 10 11 10 10 10 10 10 10 10 10 10 10 10 10 31 26 30 10 10 10 10 10 10 10 42 41 10 10 10 10 10 10 10 10 10 10 10 10 10 11 10 10 10 10 10 10 17
18 10 10 10 10 10 10 11 11 41 41 41 41 41 11 41 41 41 11 41 41 41 10 10 10 10 10 10 10 10 10 10 10 10 10 42 41 10 10 10 10 10 10 10 10 10 11 10 10 17
18 10 10 10 10 10 41 41 11 41 41 41 41 41 11 41 41 41 11 41 41 41 41 11 10 10 10 10 10 10 11 10 10 10 10 10 10 10 10 10 11 10 10 10 10 10 10 10 10 17
18 10 10 10 10 41 41 41 11 41 41 41 41 41 11 41 41 41 11 41 41 41 41 11 10 42 41 10 10 10 10 10 10 10 10 10 10 10 10 10 10 10 10 10 10 10 10 10 10 17
18 10 10 10 41 41 41 11 11 41 41 41 41 41 11 11 11 11 11 41 41 41 11 11 10 10 10 10 10 10 10 10 10 10 10 10 14 15 15 15 16 10 10 10 10 10 10 10 10 17
18 10 10 10 10 11 11 11 41 41 41 41 41 41 11 41 41 41 11 41 41 11 11 41 10 10 10 10 10 10 11 10 10 10 10 10 17 22 12 13 18 10 10 11 10 42 41 10 10 17
18 10 11 10 41 11 41 41 41 41 41 41 41 41 11 41 41 41 41 41 41 11 41 10 10 10 10 10 10 10 10 10 10 10 10 10 17 12 13 13 18 10 10 10 10 10 10 10 10 17
18 10 10 10 10 11 41 41 41 41 41 41 41 41 11 41 41 41 41 41 41 11 41 41 10 10 10 11 10 10 10 10 10 11 10 10 17 12 12 12 18 10 10 10 10 10 10 10 10 17
18 10 10 10 41 11 11 11 11 41 41 41 11 11 11 41 41 41 41 41 11 11 41 10 10 10 10 10 10 42 41 10 10 10 10 44 44 44 44 44 44 44 10 10 10 10 10 10 10 17
18 10 10 10 10 41 41 41 11 11 11 11 11 41 11 11 11 11 11 11 11 41 41 41 10 10 10 10 10 10 10 10 10 10 10 44 44 44 44 44 44 44 10 10 11 10 10 11 10 17
18 10 10 10 41 41 41 41 11 41 11 41 41 41 41 41 41 41 11 41 41 41 41 10 10 10 10 11 10 10 10 10 10 10 10 44 44 44 44 44 44 44 10 10 10 10 10 10 10 17
18 10 10 10 10 41 41 11 41 41 11 41 41 41 41 41 41 41 11 11 41 41 41 41 10 10 10 10 10 10 10 10 11 10 10 10 17 12 13 12 18 10 10 10 10 10 10 10 10 17
18 10 10 10 10 10 10 11 10 10 11 10 10 10 10 10 10 10 11 10 10 10 10 10 10 10 10 10 10 11 10 10 10 10 10 10 17 12 12 13 18 10 10 10 10 10 11 10 10 17
18 10 10 11 10 10 10 11 10 10 10 10 10 10 10 10 10 10 11 11 10 10 10 10 42 41 10 10 10 10 10 10 10 10 10 10 17 12 13 12 18 10 11 10 10 10 10 10 10 17
18 10 10 10 10 10 10 10 10 10 10 10 11 10 10 10 10 10 11 10 10 10 10 10 10 10 10 10 10 10 10 10 10 10 10 10 17 12 12 13 18 10 10 10 10 10 10 10 10 17
24 15 15 15 15 15 15 15 15 15 15 15 15 15 15 15 15 15 15 15 15 15 15 15 15 15 15 15 15 15 15 15 15 15 15 15 25 13 12 12 24 15 15 15 15 15 15 15 15 25

