31 29 29 29 29 29 29 29 29 29 29 29 29 29 29 29 29 29 29 29 29 29 29 29 29 29 29 29 29 29 29 29 29 29 29 29 29 29 29 29 29 29 29 29 29 29 29 29 29 32 
27 2 2 2 2 2 19 19 19 19 2 2 2 2 3 2 2 2 2 2 2 2 2 2 2 2 2 2 2 2 2 2 2 2 2 2 2 2 2 2 2 2 2 2 2 2 2 2 2 26 
27 2 19 19 19 2 19 5 4 19 2 2 2 2 2 2 2 2 2 2 2 2 3 2 2 2 3 2 2 2 2 2 2 2 2 2 2 2 2 2 3 2 2 2 2 2 2 3 2 26 
27 2 19 4 19 19 19 5 19 19 2 2 2 19 19 19 19 19 19 19 19 2 2 2 2 2 2 2 2 2 2 2 2 2 14 12 12 12 12 15 2 2 2 2 18 2 2 2 2 26 
27 2 19 5 19 5 5 5 19 19 19 19 2 19 5 5 5 5 5 4 19 2 2 3 2 2 2 2 2 2 2 2 2 2 10 5 5 5 5 9 2 2 2 18 18 18 2 2 2 26 
27 19 5 5 5 5 19 5 5 5 5 19 2 19 5 19 19 19 5 19 19 2 2 2 2 2 2 2 3 2 2 2 2 2 10 5 6 7 7 17 2 2 18 18 18 18 18 2 2 26 
27 19 4 19 19 5 19 19 19 19 5 19 2 19 5 19 2 10 5 12 12 12 12 12 12 12 12 12 12 12 12 12 12 12 13 5 9 2 2 2 2 2 2 2 2 2 2 2 2 26 
27 19 19 19 19 5 19 2 2 19 5 19 19 19 5 19 2 10 5 5 5 5 5 5 5 5 5 5 5 5 5 5 5 5 5 5 9 2 2 2 2 2 2 2 2 2 3 2 2 26 
27 2 2 2 19 4 19 2 2 19 5 5 5 5 5 19 2 16 7 7 7 7 7 7 7 7 7 7 7 7 8 5 6 7 7 7 2 2 2 2 2 3 2 2 2 2 2 2 2 26 
27 2 3 2 19 19 19 2 2 19 5 19 19 19 19 19 2 2 2 2 2 2 2 2 2 2 2 2 2 2 10 5 9 2 2 2 2 3 2 2 2 2 2 2 2 3 2 2 2 26 
27 2 2 2 2 2 2 2 2 19 5 19 2 2 2 2 2 2 3 2 2 2 2 2 2 2 2 2 19 2 10 5 9 2 2 2 2 2 2 2 2 2 2 2 2 2 2 2 2 26 
27 2 2 2 2 2 2 2 2 19 5 19 2 2 19 2 2 2 2 2 19 2 2 2 2 3 2 2 2 2 10 5 9 2 2 3 2 2 2 2 2 2 2 2 2 2 2 2 2 26 
27 2 2 19 19 19 19 19 19 19 5 19 2 2 2 2 2 2 2 2 2 2 2 2 2 2 2 2 2 2 10 5 9 2 2 2 2 2 19 19 19 19 19 19 19 19 3 2 2 26 
27 2 2 19 4 5 5 5 5 5 5 19 2 2 2 2 2 2 3 2 2 2 3 2 2 2 2 2 2 2 10 5 9 2 2 2 2 2 19 20 20 20 20 20 20 19 2 2 2 26 
27 2 2 19 19 19 19 19 5 5 19 19 2 2 3 2 2 2 19 2 2 2 2 2 2 19 3 2 2 2 10 5 11 12 12 12 15 2 19 20 4 4 4 4 20 19 2 2 2 26 
27 2 2 2 2 2 2 19 5 5 2 2 2 2 2 2 2 2 2 2 2 2 2 2 2 2 2 2 2 2 10 5 5 5 5 5 9 2 19 20 4 4 4 4 20 19 2 2 2 26 
27 2 2 2 2 2 2 19 5 5 2 2 2 2 2 2 2 2 3 2 2 2 3 2 2 2 2 2 19 2 10 5 6 7 7 7 17 2 19 20 4 4 4 4 20 19 2 2 2 26 
27 2 3 2 2 2 2 19 5 5 19 2 2 2 2 2 2 2 2 2 2 2 2 2 2 2 2 2 2 2 10 5 9 2 2 2 2 2 19 20 20 20 20 20 20 19 2 2 2 26 
27 2 2 2 2 2 2 19 5 5 19 19 19 19 19 19 19 19 19 19 19 19 19 19 19 2 2 2 2 2 10 5 9 2 2 2 2 2 19 19 19 19 19 19 19 19 2 2 2 26 
27 2 2 2 2 2 2 19 5 5 12 12 12 12 12 12 12 12 12 12 12 12 12 15 19 2 2 2 3 2 10 5 9 2 2 2 2 2 2 2 2 3 2 2 2 2 2 2 2 26 
27 2 2 2 2 2 2 19 5 5 5 5 5 5 5 5 5 5 5 5 5 5 5 9 19 2 2 2 19 2 10 5 9 2 2 2 2 2 2 2 2 2 2 2 2 2 2 3 2 26 
27 2 2 2 2 2 2 19 19 19 19 7 7 7 7 7 7 7 7 7 7 8 5 9 19 2 2 2 2 2 10 5 9 2 2 3 2 2 3 2 2 2 2 2 2 2 2 2 2 26 
27 2 19 19 19 3 2 2 2 2 19 23 24 24 24 24 24 24 24 24 25 10 5 9 19 2 2 2 2 2 10 5 9 2 2 2 2 2 2 2 2 2 2 0 0 0 2 2 2 26 
27 2 19 4 19 3 2 2 2 2 19 26 21 22 21 21 21 21 21 22 27 10 5 9 19 2 2 2 2 3 10 5 11 12 12 12 12 12 12 15 2 2 0 0 0 0 0 2 2 26 
27 2 19 5 19 2 2 2 2 2 19 26 21 21 21 22 22 21 21 21 27 10 5 9 19 2 2 2 2 2 10 5 5 5 5 5 5 5 5 9 2 0 0 0 21 0 0 0 2 26 
27 2 19 5 19 2 2 2 2 2 19 26 21 21 22 21 22 21 21 21 27 10 5 9 19 2 3 2 2 2 16 7 7 7 7 7 7 7 7 17 2 0 0 21 21 21 0 0 2 26 
27 2 19 5 19 2 3 2 2 2 19 26 21 21 21 21 22 21 22 21 27 10 5 9 19 2 2 2 2 2 2 2 2 2 2 2 2 2 2 2 2 0 0 21 0 0 0 0 2 26 
27 2 19 5 19 2 2 2 2 2 19 26 21 22 21 21 21 22 21 21 27 10 5 9 19 2 4 19 2 2 2 2 2 2 2 2 2 2 2 2 2 0 0 21 21 21 0 0 2 26 
27 2 3 7 2 2 2 2 2 2 19 28 21 29 29 29 29 29 29 29 30 10 5 9 19 2 2 2 2 2 2 2 2 3 2 2 3 2 2 2 2 0 0 0 0 21 0 0 2 26 
27 2 2 2 2 2 2 2 2 2 19 19 19 19 19 19 19 14 12 12 12 13 5 9 2 2 2 2 2 2 2 2 2 2 2 2 2 2 2 2 2 0 0 21 21 21 0 0 2 26 
27 2 2 2 2 2 2 3 2 2 2 2 2 2 2 2 2 10 5 5 5 5 5 9 2 2 2 2 2 2 2 2 2 4 19 2 2 2 2 2 2 2 0 0 21 0 0 2 2 26 
27 2 2 2 2 3 2 2 2 2 2 2 3 2 2 2 2 10 5 6 7 7 7 17 2 2 2 2 2 2 2 2 2 2 2 2 2 2 2 3 2 2 2 0 0 0 2 2 2 26 
27 3 2 2 2 2 2 2 2 2 2 2 2 2 2 2 2 10 5 9 2 2 2 2 2 2 2 2 2 2 2 2 3 2 2 3 2 2 2 2 2 2 2 2 2 2 2 2 2 26 
27 2 2 2 2 2 2 2 2 2 2 2 2 2 2 2 2 10 5 9 2 4 19 2 2 2 2 2 2 2 2 2 2 2 2 2 2 2 2 2 2 2 2 2 2 2 3 2 2 26 
27 2 2 2 3 2 2 2 2 2 2 2 2 2 2 2 2 10 5 9 2 2 2 2 2 2 2 4 19 2 2 2 2 2 2 2 2 2 2 2 2 2 3 2 2 2 2 2 2 26 
27 2 2 2 2 2 2 3 3 19 19 19 19 19 3 19 19 19 3 19 19 19 2 2 2 2 2 2 2 2 2 2 2 2 2 4 19 2 2 2 2 2 2 2 2 2 3 2 2 26 
27 2 2 2 2 2 19 19 3 19 19 19 19 19 3 19 19 19 3 19 19 19 19 3 2 2 2 2 2 2 3 2 2 2 2 2 2 2 2 2 3 2 2 2 2 2 2 2 2 26 
27 2 2 2 2 19 19 19 3 19 19 19 19 19 3 19 19 19 3 19 19 19 19 3 2 4 19 2 2 2 2 2 2 2 2 2 2 2 2 2 2 2 2 2 2 2 2 2 2 26 
27 2 2 2 19 19 19 3 3 19 19 19 19 19 3 3 3 3 3 19 19 19 3 3 2 2 2 2 2 2 2 2 2 2 2 2 23 24 24 24 25 2 2 2 2 2 2 2 2 26 
27 2 2 2 2 3 3 3 19 19 19 19 19 19 3 19 19 19 3 19 19 3 3 19 2 2 2 2 2 2 3 2 2 2 2 2 26 22 21 22 27 2 2 3 2 4 19 2 2 26 
27 2 3 2 19 3 19 19 19 19 19 19 19 19 3 19 19 19 19 19 19 3 19 2 2 2 2 2 2 2 2 2 2 2 2 2 26 21 22 22 27 2 2 2 2 2 2 2 2 26 
27 2 2 2 2 3 19 19 19 19 19 19 19 19 3 19 19 19 19 19 19 3 19 19 2 2 2 3 2 2 2 2 2 3 2 2 26 21 21 21 27 2 2 2 2 2 2 2 2 26 
27 2 2 2 19 3 3 3 3 19 19 19 3 3 3 19 19 19 19 19 3 3 19 2 2 2 2 2 2 4 19 2 2 2 2 1 1 1 1 1 1 1 2 2 2 2 2 2 2 26 
27 2 2 2 2 19 19 19 3 3 3 3 3 19 3 3 3 3 3 3 3 19 19 19 2 2 2 2 2 2 2 2 2 2 2 1 1 1 1 1 1 1 2 2 3 2 2 3 2 26 
27 2 2 2 19 19 19 19 3 19 3 19 19 19 19 19 19 19 3 19 19 19 19 2 2 2 2 3 2 2 2 2 2 2 2 1 1 1 1 1 1 1 2 2 2 2 2 2 2 26 
27 2 2 2 2 19 19 3 19 19 3 19 19 19 19 19 19 19 3 3 19 19 19 19 2 2 2 2 2 2 2 2 3 2 2 2 26 21 22 21 27 2 2 2 2 2 2 2 2 26 
27 2 2 2 2 2 2 3 2 2 3 2 2 2 2 2 2 2 2 3 2 2 2 2 2 2 2 2 2 3 2 2 2 2 2 2 26 21 21 22 27 2 2 2 2 2 3 2 2 26 
27 2 2 3 2 2 2 3 2 2 2 2 2 2 2 2 2 2 2 3 3 2 2 2 2 4 19 2 2 2 2 2 2 2 2 2 26 21 22 21 27 2 3 2 2 2 2 2 2 26 
27 2 2 2 2 2 2 2 2 2 2 2 3 2 2 2 2 2 2 2 2 2 2 2 2 2 2 2 2 2 2 2 2 2 2 2 26 21 21 22 27 2 2 2 2 2 2 2 2 26 
33 24 24 24 24 24 24 24 24 24 24 24 24 24 24 24 24 24 24 24 24 24 24 24 24 24 24 24 24 24 24 24 24 24 24 24 34 22 21 21 33 24 24 24 24 24 24 24 24 34 
